Contract Code,Metric,Value1,Value2,Value3,Value4,Value5,Date
IMOEXF,Открытые позиции,364821,147568,31083,248336,791808,2025-01-16
IMOEXF,Изменение,1170,-9094,-5825,4439,-9310,2025-01-16
IMOEXF,Количество лиц,4843,2585,27,13,7468,2025-01-16
SBRF-3.25,Открытые позиции,149716,96800,169457,222373,638346,2025-01-16
SBRF-3.25,Изменение,-15923,-2334,21373,7784,10900,2025-01-16
SBRF-3.25,Количество лиц,4188,2531,70,41,6830,2025-01-16
GAZR-3.25,Открытые позиции,117818,109062,241747,250503,719130,2025-01-16
GAZR-3.25,Изменение,-9231,1351,9825,-757,1188,2025-01-16
GAZR-3.25,Количество лиц,2246,1941,37,46,4270,2025-01-16
SMLT-3.25,Открытые позиции,225002,204933,821,20890,451646,2025-01-16
SMLT-3.25,Изменение,3768,5237,372,-1097,8280,2025-01-16
SMLT-3.25,Количество лиц,821,590,4,21,1436,2025-01-16
GMKN-3.25,Открытые позиции,384634,99170,87188,372652,943644,2025-01-16
GMKN-3.25,Изменение,49231,-6068,-629,54670,97204,2025-01-16
GMKN-3.25,Количество лиц,1024,553,7,63,1647,2025-01-16
YDEX-3.25,Открытые позиции,197596,38512,13008,172092,421208,2025-01-16
YDEX-3.25,Изменение,-3194,-1035,768,-1391,-4852,2025-01-16
YDEX-3.25,Количество лиц,1321,429,8,50,1808,2025-01-16
MGNT-3.25,Открытые позиции,43087,66558,194617,171146,475408,2025-01-16
MGNT-3.25,Изменение,1984,-2556,392,4932,4752,2025-01-16
MGNT-3.25,Количество лиц,886,782,10,50,1728,2025-01-16
ISKJ-3.25,Открытые позиции,12270,7944,0,4326,24540,2025-01-16
ISKJ-3.25,Изменение,-22,-710,0,688,-44,2025-01-16
ISKJ-3.25,Количество лиц,77,56,0,12,145,2025-01-16
VTBR-3.25,Открытые позиции,63113,28739,51897,86271,230020,2025-01-16
VTBR-3.25,Изменение,-2494,1559,1949,-2104,-1090,2025-01-16
VTBR-3.25,Количество лиц,1144,680,12,15,1851,2025-01-16
SGZH-3.25,Открытые позиции,145553,143386,393,2560,291892,2025-01-16
SGZH-3.25,Изменение,-612,-2464,-1369,483,-3962,2025-01-16
SGZH-3.25,Количество лиц,784,388,1,6,1179,2025-01-16
TRNF-3.25,Открытые позиции,84043,34525,7147,56665,182380,2025-01-16
TRNF-3.25,Изменение,404,2136,0,-1732,808,2025-01-16
TRNF-3.25,Количество лиц,625,270,3,18,916,2025-01-16
WUSH-3.25,Открытые позиции,44011,18500,99,25610,88220,2025-01-16
WUSH-3.25,Изменение,-6,415,93,-328,174,2025-01-16
WUSH-3.25,Количество лиц,351,235,1,18,605,2025-01-16
VKCO-3.25,Открытые позиции,41524,39710,7628,9442,98304,2025-01-16
VKCO-3.25,Изменение,-1376,19267,5893,-14750,9034,2025-01-16
VKCO-3.25,Количество лиц,685,657,7,13,1362,2025-01-16
ALIBABA-3.25,Открытые позиции,12552,1120,3165,14597,31434,2025-01-16
ALIBABA-3.25,Изменение,-804,75,0,-879,-1608,2025-01-16
ALIBABA-3.25,Количество лиц,539,33,4,3,579,2025-01-16
BAIDU-3.25,Открытые позиции,19809,745,1119,20183,41856,2025-01-16
BAIDU-3.25,Изменение,-8,137,0,-145,-16,2025-01-16
BAIDU-3.25,Количество лиц,380,26,2,2,410,2025-01-16
SIBN-3.25,Открытые позиции,18175,14025,57,4207,36464,2025-01-16
SIBN-3.25,Изменение,-6,1141,-25,-1172,-62,2025-01-16
SIBN-3.25,Количество лиц,401,226,2,12,641,2025-01-16
SBERF,Открытые позиции,44612,15011,446,30047,90116,2025-01-16
SBERF,Изменение,3761,-459,-93,4127,7336,2025-01-16
SBERF,Количество лиц,1004,379,5,20,1408,2025-01-16
RNFT-3.25,Открытые позиции,31565,27549,3163,7179,69456,2025-01-16
RNFT-3.25,Изменение,129,803,734,60,1726,2025-01-16
RNFT-3.25,Количество лиц,254,227,3,7,491,2025-01-16
GAZPF,Открытые позиции,47808,24482,9119,32445,113854,2025-01-16
GAZPF,Изменение,1057,-764,-738,1083,638,2025-01-16
GAZPF,Количество лиц,733,296,7,15,1051,2025-01-16
MVID-3.25,Открытые позиции,32897,58746,25849,0,117492,2025-01-16
MVID-3.25,Изменение,-89,2138,2227,0,4276,2025-01-16
MVID-3.25,Количество лиц,224,248,3,0,475,2025-01-16
PIKK-3.25,Открытые позиции,5196,24405,20415,1206,51222,2025-01-16
PIKK-3.25,Изменение,326,-58,-61,323,530,2025-01-16
PIKK-3.25,Количество лиц,179,404,6,12,601,2025-01-16
BELUGA-3.25,Открытые позиции,23450,11359,1877,13968,50654,2025-01-16
BELUGA-3.25,Изменение,-4318,655,-13,-4986,-8662,2025-01-16
BELUGA-3.25,Количество лиц,180,48,1,9,238,2025-01-16
MTLR-3.25,Открытые позиции,10030,30566,20854,318,61768,2025-01-16
MTLR-3.25,Изменение,137,798,771,110,1816,2025-01-16
MTLR-3.25,Количество лиц,395,558,4,9,966,2025-01-16
POSI-3.25,Открытые позиции,33409,28501,4556,9464,75930,2025-01-16
POSI-3.25,Изменение,-355,2464,2467,-352,4224,2025-01-16
POSI-3.25,Количество лиц,399,148,3,9,559,2025-01-16
ASTR-3.25,Открытые позиции,54009,26465,339,27883,108696,2025-01-16
ASTR-3.25,Изменение,2057,532,287,1812,4688,2025-01-16
ASTR-3.25,Количество лиц,307,118,3,4,432,2025-01-16
SOFL-3.25,Открытые позиции,11135,1506,0,9629,22270,2025-01-16
SOFL-3.25,Изменение,96,79,0,17,192,2025-01-16
SOFL-3.25,Количество лиц,128,38,0,8,174,2025-01-16
ALRS-3.25,Открытые позиции,24292,10110,79213,93395,207010,2025-01-16
ALRS-3.25,Изменение,-236,152,78,-310,-316,2025-01-16
ALRS-3.25,Количество лиц,411,331,4,41,787,2025-01-16
NLMK-3.25,Открытые позиции,32848,5086,2053,29815,69802,2025-01-16
NLMK-3.25,Изменение,1612,287,2,1327,3228,2025-01-16
NLMK-3.25,Количество лиц,421,276,4,26,727,2025-01-16
AFLT-3.25,Открытые позиции,23494,20232,2192,5454,51372,2025-01-16
AFLT-3.25,Изменение,-926,-3763,17,2854,-1818,2025-01-16
AFLT-3.25,Количество лиц,399,413,6,25,843,2025-01-16
BANE-3.25,Открытые позиции,3817,12546,9083,354,25800,2025-01-16
BANE-3.25,Изменение,-92,297,543,154,902,2025-01-16
BANE-3.25,Количество лиц,130,146,2,3,281,2025-01-16
RUAL-3.25,Открытые позиции,10254,10853,1042,443,22592,2025-01-16
RUAL-3.25,Изменение,-841,1484,389,-1936,-904,2025-01-16
RUAL-3.25,Количество лиц,235,208,6,6,455,2025-01-16
LEAS-3.25,Открытые позиции,37456,10008,1,27449,74914,2025-01-16
LEAS-3.25,Изменение,4052,209,0,3843,8104,2025-01-16
LEAS-3.25,Количество лиц,199,80,1,16,296,2025-01-16
AFKS-3.25,Открытые позиции,5586,18035,16124,3675,43420,2025-01-16
AFKS-3.25,Изменение,-64,-860,-354,442,-836,2025-01-16
AFKS-3.25,Количество лиц,182,531,2,26,741,2025-01-16
RTKM-3.25,Открытые позиции,8842,5721,48054,51175,113792,2025-01-16
RTKM-3.25,Изменение,718,171,-1,546,1434,2025-01-16
RTKM-3.25,Количество лиц,286,179,3,25,493,2025-01-16
SFIN-3.25,Открытые позиции,13194,4803,0,8391,26388,2025-01-16
SFIN-3.25,Изменение,186,-13,0,199,372,2025-01-16
SFIN-3.25,Количество лиц,175,65,0,7,247,2025-01-16
MOEX-3.25,Открытые позиции,11878,7317,205,4766,24166,2025-01-16
MOEX-3.25,Изменение,-197,351,55,-493,-284,2025-01-16
MOEX-3.25,Количество лиц,416,238,5,33,692,2025-01-16
SBPR-3.25,Открытые позиции,4070,2996,625,1699,9390,2025-01-16
SBPR-3.25,Изменение,-718,-35,198,-485,-1040,2025-01-16
SBPR-3.25,Количество лиц,239,195,8,10,452,2025-01-16
ROSN-3.25,Открытые позиции,4233,7593,19715,16355,47896,2025-01-16
ROSN-3.25,Изменение,184,-534,-86,632,196,2025-01-16
ROSN-3.25,Количество лиц,573,557,8,32,1170,2025-01-16
TCSI-3.25,Открытые позиции,21931,6911,18089,33109,80040,2025-01-16
TCSI-3.25,Изменение,684,-138,-275,547,818,2025-01-16
TCSI-3.25,Количество лиц,725,409,15,39,1188,2025-01-16
FESH-3.25,Открытые позиции,7093,7142,200,151,14586,2025-01-16
FESH-3.25,Изменение,-8,-122,-53,61,-122,2025-01-16
FESH-3.25,Количество лиц,122,147,1,5,275,2025-01-16
PHOR-3.25,Открытые позиции,42319,9230,453,33542,85544,2025-01-16
PHOR-3.25,Изменение,125,360,-35,-270,180,2025-01-16
PHOR-3.25,Количество лиц,218,227,2,27,474,2025-01-16
SVCB-3.25,Открытые позиции,48974,14575,2076,36475,102100,2025-01-16
SVCB-3.25,Изменение,10554,403,-4191,5960,12726,2025-01-16
SVCB-3.25,Количество лиц,238,132,2,14,386,2025-01-16
CBOM-3.25,Открытые позиции,1077,11450,10543,170,23240,2025-01-16
CBOM-3.25,Изменение,-15,-371,-364,-8,-758,2025-01-16
CBOM-3.25,Количество лиц,65,259,2,4,330,2025-01-16
LKOH-3.25,Открытые позиции,5597,5943,7100,6754,25394,2025-01-16
LKOH-3.25,Изменение,-513,-114,61,-338,-904,2025-01-16
LKOH-3.25,Количество лиц,571,455,14,29,1069,2025-01-16
KMAZ-3.25,Открытые позиции,6202,2150,103,4155,12610,2025-01-16
KMAZ-3.25,Изменение,266,86,-18,162,496,2025-01-16
KMAZ-3.25,Количество лиц,138,81,2,9,230,2025-01-16
SNGR-3.25,Открытые позиции,13190,2718,2090,12562,30560,2025-01-16
SNGR-3.25,Изменение,61,33,34,62,190,2025-01-16
SNGR-3.25,Количество лиц,407,149,7,31,594,2025-01-16
HYDR-3.25,Открытые позиции,4307,3597,1422,2132,11458,2025-01-16
HYDR-3.25,Изменение,-336,-43,131,-162,-410,2025-01-16
HYDR-3.25,Количество лиц,177,99,3,2,281,2025-01-16
NOTK-3.25,Открытые позиции,3525,2340,723,1908,8496,2025-01-16
NOTK-3.25,Изменение,-14,-104,-3,87,-34,2025-01-16
NOTK-3.25,Количество лиц,364,330,3,21,718,2025-01-16
T-6.25,Открытые позиции,5855,2992,17,2880,11744,2025-01-16
T-6.25,Изменение,222,160,-13,49,418,2025-01-16
T-6.25,Количество лиц,163,47,1,3,214,2025-01-16
FEES-3.25,Открытые позиции,5392,1111,113,4394,11010,2025-01-16
FEES-3.25,Изменение,891,-5,-51,845,1680,2025-01-16
FEES-3.25,Количество лиц,210,93,1,12,316,2025-01-16
MAGN-3.25,Открытые позиции,1295,1021,894,1168,4378,2025-01-16
MAGN-3.25,Изменение,136,-127,-71,192,130,2025-01-16
MAGN-3.25,Количество лиц,162,108,6,7,283,2025-01-16
BSPB-3.25,Открытые позиции,10806,10013,3764,4557,29140,2025-01-16
BSPB-3.25,Изменение,2836,-335,-24,3147,5624,2025-01-16
BSPB-3.25,Количество лиц,233,211,2,11,457,2025-01-16
TATN-3.25,Открытые позиции,975,1796,1209,388,4368,2025-01-16
TATN-3.25,Изменение,-307,-268,51,12,-512,2025-01-16
TATN-3.25,Количество лиц,151,151,6,5,313,2025-01-16
FLOT-3.25,Открытые позиции,6884,6067,2569,3386,18906,2025-01-16
FLOT-3.25,Изменение,442,262,0,180,884,2025-01-16
FLOT-3.25,Количество лиц,257,255,3,7,522,2025-01-16
MTSI-3.25,Открытые позиции,3194,3904,1180,470,8748,2025-01-16
MTSI-3.25,Изменение,-85,199,92,-192,14,2025-01-16
MTSI-3.25,Количество лиц,239,266,4,10,519,2025-01-16
TATP-3.25,Открытые позиции,2310,808,118,1620,4856,2025-01-16
TATP-3.25,Изменение,69,-6,18,93,174,2025-01-16
TATP-3.25,Количество лиц,88,51,2,7,148,2025-01-16
CHMF-3.25,Открытые позиции,537,456,274,355,1622,2025-01-16
CHMF-3.25,Изменение,68,57,-11,0,114,2025-01-16
CHMF-3.25,Количество лиц,106,114,5,15,240,2025-01-16
RASP-3.25,Открытые позиции,3715,2482,475,1708,8380,2025-01-16
RASP-3.25,Изменение,9,-39,31,79,80,2025-01-16
RASP-3.25,Количество лиц,59,69,1,7,136,2025-01-16
IRAO-3.25,Открытые позиции,1258,416,952,1794,4420,2025-01-16
IRAO-3.25,Изменение,106,37,-8,61,196,2025-01-16
IRAO-3.25,Количество лиц,167,44,3,13,227,2025-01-16
SNGP-3.25,Открытые позиции,1814,1851,384,347,4396,2025-01-16
SNGP-3.25,Изменение,-14,-54,-19,21,-66,2025-01-16
SNGP-3.25,Количество лиц,264,118,7,7,396,2025-01-16
PLZL-3.25,Открытые позиции,919,1125,652,446,3142,2025-01-16
PLZL-3.25,Изменение,51,42,43,52,188,2025-01-16
PLZL-3.25,Количество лиц,172,151,7,9,339,2025-01-16
SPBE-3.25,Открытые позиции,1333,119,3,1217,2672,2025-01-16
SPBE-3.25,Изменение,618,-9,0,627,1236,2025-01-16
SPBE-3.25,Количество лиц,39,15,1,5,60,2025-01-16
