Contract Code,Metric,Value1,Value2,Value3,Value4,Value5,Date
IMOEXF,Открытые позиции,457461,211628,41827,287660,998576,2025-02-19
IMOEXF,Изменение,32764,-4181,-16479,20466,32570,2025-02-19
IMOEXF,Количество лиц,5507,2791,22,21,8341,2025-02-19
SBER,Открытые позиции,159441,73025,243973,330389,806828,2025-02-19
SBER,Изменение,-20822,-626,25321,5125,8998,2025-02-19
SBER,Количество лиц,4871,2162,75,37,7145,2025-02-19
GAZP,Открытые позиции,179377,100775,204574,283176,767902,2025-02-19
GAZP,Изменение,24113,1702,-3369,19042,41488,2025-02-19
GAZP,Количество лиц,2913,2327,38,97,5375,2025-02-19
SMLT,Открытые позиции,284193,153698,3259,133754,574904,2025-02-19
SMLT,Изменение,-4067,-4248,0,181,-8134,2025-02-19
SMLT,Количество лиц,1044,632,1,36,1713,2025-02-19
GMKN,Открытые позиции,305591,93513,90390,302468,791962,2025-02-19
GMKN,Изменение,-47243,-14591,-9077,-41729,-112640,2025-02-19
GMKN,Количество лиц,1516,575,12,41,2144,2025-02-19
YDEX,Открытые позиции,183994,40762,15547,158779,399082,2025-02-19
YDEX,Изменение,1821,-1700,129,3650,3900,2025-02-19
YDEX,Количество лиц,1335,383,7,42,1767,2025-02-19
MGNT,Открытые позиции,54087,67028,159214,146273,426602,2025-02-19
MGNT,Изменение,-1419,-39,41,-1339,-2756,2025-02-19
MGNT,Количество лиц,1012,411,9,41,1473,2025-02-19
ABIO,Открытые позиции,11467,6658,26,4835,22986,2025-02-19
ABIO,Изменение,-3702,1565,26,-5241,-7352,2025-02-19
ABIO,Количество лиц,78,47,1,11,137,2025-02-19
VTBR,Открытые позиции,176667,26966,58492,208193,470318,2025-02-19
VTBR,Изменение,3939,-6841,-3429,7351,1020,2025-02-19
VTBR,Количество лиц,2738,808,18,48,3612,2025-02-19
SGZH,Открытые позиции,120401,129858,9701,244,260204,2025-02-19
SGZH,Изменение,-5058,11112,8569,-7601,7022,2025-02-19
SGZH,Количество лиц,864,717,7,2,1590,2025-02-19
TRNFP,Открытые позиции,116587,21182,3159,98564,239492,2025-02-19
TRNFP,Изменение,-11089,759,571,-11277,-21036,2025-02-19
TRNFP,Количество лиц,747,208,3,14,972,2025-02-19
WUSH,Открытые позиции,58354,19621,547,39280,117802,2025-02-19
WUSH,Изменение,4762,-74,-196,4640,9132,2025-02-19
WUSH,Количество лиц,495,148,3,22,668,2025-02-19
VKCO,Открытые позиции,73339,14753,3706,62292,154090,2025-02-19
VKCO,Изменение,-10586,515,153,-10948,-20866,2025-02-19
VKCO,Количество лиц,959,309,5,25,1298,2025-02-19
BABA,Открытые позиции,20044,9180,500,11364,41088,2025-02-19
BABA,Изменение,14095,1873,-1235,10987,25720,2025-02-19
BABA,Количество лиц,412,284,1,3,700,2025-02-19
BIDU,Открытые позиции,22923,1711,0,21212,45846,2025-02-19
BIDU,Изменение,3749,-641,0,4390,7498,2025-02-19
BIDU,Количество лиц,322,47,0,3,372,2025-02-19
SIBN,Открытые позиции,31081,5182,22,25921,62206,2025-02-19
SIBN,Изменение,-161,254,7,-408,-308,2025-02-19
SIBN,Количество лиц,893,153,2,19,1067,2025-02-19
RNFT,Открытые позиции,33050,36220,3297,127,72694,2025-02-19
RNFT,Изменение,-3082,-3593,-1565,-1054,-9294,2025-02-19
RNFT,Количество лиц,300,342,4,2,648,2025-02-19
MVID,Открытые позиции,22336,23433,1290,193,47252,2025-02-19
MVID,Изменение,1927,-415,-2291,51,-728,2025-02-19
MVID,Количество лиц,187,187,1,3,378,2025-02-19
PIKK,Открытые позиции,8432,65493,57534,473,131932,2025-02-19
PIKK,Изменение,936,-3004,-4947,-1007,-8022,2025-02-19
PIKK,Количество лиц,288,944,6,10,1248,2025-02-19
BELU,Открытые позиции,32038,10362,523,22199,65122,2025-02-19
BELU,Изменение,-7743,-52,523,-7168,-14440,2025-02-19
BELU,Количество лиц,209,68,1,6,284,2025-02-19
MTLR,Открытые позиции,8476,21607,15845,2714,48642,2025-02-19
MTLR,Изменение,-333,785,1084,-34,1502,2025-02-19
MTLR,Количество лиц,513,445,9,9,976,2025-02-19
POSI,Открытые позиции,112659,93201,3642,23100,232602,2025-02-19
POSI,Изменение,-3032,-4872,-283,1557,-6630,2025-02-19
POSI,Количество лиц,1281,469,6,20,1776,2025-02-19
ASTR,Открытые позиции,68609,18072,100,50637,137418,2025-02-19
ASTR,Изменение,-145,5392,100,-5437,-90,2025-02-19
ASTR,Количество лиц,481,104,1,12,598,2025-02-19
SOFL,Открытые позиции,25101,5289,20,19832,50242,2025-02-19
SOFL,Изменение,2049,2040,20,29,4138,2025-02-19
SOFL,Количество лиц,223,55,1,12,291,2025-02-19
ALRS,Открытые позиции,24716,7574,79520,96662,208472,2025-02-19
ALRS,Изменение,116,-26,159,301,550,2025-02-19
ALRS,Количество лиц,547,249,6,31,833,2025-02-19
NLMK,Открытые позиции,31183,4146,2222,29259,66810,2025-02-19
NLMK,Изменение,-2002,-33,-8,-1977,-4020,2025-02-19
NLMK,Количество лиц,503,226,7,21,757,2025-02-19
AFLT,Открытые позиции,27685,21664,2941,8962,61252,2025-02-19
AFLT,Изменение,-4,-123,244,363,480,2025-02-19
AFLT,Количество лиц,659,431,6,20,1116,2025-02-19
BANE,Открытые позиции,5586,10419,4954,121,21080,2025-02-19
BANE,Изменение,405,463,74,16,958,2025-02-19
BANE,Количество лиц,157,115,5,2,279,2025-02-19
RUAL,Открытые позиции,9406,6467,1022,3961,20856,2025-02-19
RUAL,Изменение,-85,1889,559,-1415,948,2025-02-19
RUAL,Количество лиц,297,149,3,12,461,2025-02-19
LEAS,Открытые позиции,30285,7208,1464,24541,63498,2025-02-19
LEAS,Изменение,737,-4,1463,2204,4400,2025-02-19
LEAS,Количество лиц,207,84,2,13,306,2025-02-19
AFKS,Открытые позиции,10880,13389,3024,515,27808,2025-02-19
AFKS,Изменение,-388,934,905,-417,1034,2025-02-19
AFKS,Количество лиц,390,306,8,7,711,2025-02-19
RTKM,Открытые позиции,10831,6073,48435,53193,118532,2025-02-19
RTKM,Изменение,1348,20,11,1339,2718,2025-02-19
RTKM,Количество лиц,353,138,4,16,511,2025-02-19
SFIN,Открытые позиции,16938,5394,136,11680,34148,2025-02-19
SFIN,Изменение,-2317,310,0,-2627,-4634,2025-02-19
SFIN,Количество лиц,221,59,1,7,288,2025-02-19
MOEX,Открытые позиции,14346,5002,528,9872,29748,2025-02-19
MOEX,Изменение,-2065,185,-7,-2257,-4144,2025-02-19
MOEX,Количество лиц,901,227,4,23,1155,2025-02-19
SBERP,Открытые позиции,5897,1827,100,4170,11994,2025-02-19
SBERP,Изменение,-1620,-138,-21,-1503,-3282,2025-02-19
SBERP,Количество лиц,348,133,3,23,507,2025-02-19
ROSN,Открытые позиции,5809,3091,8514,11232,28646,2025-02-19
ROSN,Изменение,-524,118,-856,-1498,-2760,2025-02-19
ROSN,Количество лиц,563,327,12,28,930,2025-02-19
T,Открытые позиции,19949,4284,378,16043,40654,2025-02-19
T,Изменение,436,-430,-4,862,864,2025-02-19
T,Количество лиц,744,249,2,22,1017,2025-02-19
FESH,Открытые позиции,7625,5117,0,2508,15250,2025-02-19
FESH,Изменение,355,-486,0,841,710,2025-02-19
FESH,Количество лиц,155,100,0,10,265,2025-02-19
PHOR,Открытые позиции,42915,11171,603,32347,87036,2025-02-19
PHOR,Изменение,-399,1716,-110,-2225,-1018,2025-02-19
PHOR,Количество лиц,288,279,6,16,589,2025-02-19
SVCB,Открытые позиции,71753,7788,936,64901,145378,2025-02-19
SVCB,Изменение,896,-2268,236,3400,2264,2025-02-19
SVCB,Количество лиц,736,109,2,16,863,2025-02-19
CBOM,Открытые позиции,907,6115,6333,1125,14480,2025-02-19
CBOM,Изменение,1,-356,-51,306,-100,2025-02-19
CBOM,Количество лиц,56,167,2,9,234,2025-02-19
LKOH,Открытые позиции,5363,4720,4524,5167,19774,2025-02-19
LKOH,Изменение,-525,70,-36,-631,-1122,2025-02-19
LKOH,Количество лиц,607,376,13,22,1018,2025-02-19
KMAZ,Открытые позиции,10092,1869,15,8238,20214,2025-02-19
KMAZ,Изменение,391,-471,15,877,812,2025-02-19
KMAZ,Количество лиц,139,54,1,10,204,2025-02-19
SNGS,Открытые позиции,11491,2471,2236,11256,27454,2025-02-19
SNGS,Изменение,-133,255,13,-375,-240,2025-02-19
SNGS,Количество лиц,357,129,8,30,524,2025-02-19
HYDR,Открытые позиции,10274,3948,281,6607,21110,2025-02-19
HYDR,Изменение,136,-98,172,406,616,2025-02-19
HYDR,Количество лиц,225,118,5,15,363,2025-02-19
NVTK,Открытые позиции,4274,2778,965,2461,10478,2025-02-19
NVTK,Изменение,-531,-60,67,-404,-928,2025-02-19
NVTK,Количество лиц,473,266,8,13,760,2025-02-19
FEES,Открытые позиции,4613,751,428,4290,10082,2025-02-19
FEES,Изменение,376,178,39,237,830,2025-02-19
FEES,Количество лиц,212,63,3,9,287,2025-02-19
MAGN,Открытые позиции,2720,1559,342,1503,6124,2025-02-19
MAGN,Изменение,696,64,-603,29,186,2025-02-19
MAGN,Количество лиц,266,90,5,14,375,2025-02-19
BSPB,Открытые позиции,15621,7455,58,8224,31358,2025-02-19
BSPB,Изменение,-1004,-67,2,-935,-2004,2025-02-19
BSPB,Количество лиц,333,177,2,14,526,2025-02-19
TATN,Открытые позиции,801,2936,2216,81,6034,2025-02-19
TATN,Изменение,-6,67,107,34,202,2025-02-19
TATN,Количество лиц,119,134,10,7,270,2025-02-19
FLOT,Открытые позиции,6461,2300,572,4733,14066,2025-02-19
FLOT,Изменение,152,-714,-169,697,-34,2025-02-19
FLOT,Количество лиц,291,151,2,14,458,2025-02-19
MTSS,Открытые позиции,3395,4575,1569,389,9928,2025-02-19
MTSS,Изменение,53,452,145,-254,396,2025-02-19
MTSS,Количество лиц,221,237,7,9,474,2025-02-19
TATNP,Открытые позиции,1547,845,663,1365,4420,2025-02-19
TATNP,Изменение,-91,-47,21,-23,-140,2025-02-19
TATNP,Количество лиц,101,56,3,6,166,2025-02-19
CHMF,Открытые позиции,577,1600,1042,19,3238,2025-02-19
CHMF,Изменение,72,44,-19,9,106,2025-02-19
CHMF,Количество лиц,153,94,9,7,263,2025-02-19
RASP,Открытые позиции,9953,22041,12118,30,44142,2025-02-19
RASP,Изменение,6988,17704,10145,-571,34266,2025-02-19
RASP,Количество лиц,175,131,9,1,316,2025-02-19
IRAO,Открытые позиции,2521,792,823,2552,6688,2025-02-19
IRAO,Изменение,-95,-41,5,-49,-180,2025-02-19
IRAO,Количество лиц,250,49,4,11,314,2025-02-19
SNGSP,Открытые позиции,3197,1485,104,1816,6602,2025-02-19
SNGSP,Изменение,-66,14,-13,-93,-158,2025-02-19
SNGSP,Количество лиц,323,69,5,18,415,2025-02-19
PLZL,Открытые позиции,853,1984,2593,1462,6892,2025-02-19
PLZL,Изменение,207,-9,-69,147,276,2025-02-19
PLZL,Количество лиц,210,300,8,24,542,2025-02-19
SPBE,Открытые позиции,5492,3008,34,2518,11052,2025-02-19
SPBE,Изменение,1315,-444,-230,1529,2170,2025-02-19
SPBE,Количество лиц,157,111,1,7,276,2025-02-19
