Contract Code,Metric,Value1,Value2,Value3,Value4,Value5,Date
IMOEXF,Открытые позиции,490821,285046,36715,242490,1055072,2025-06-19
IMOEXF,Изменение,29326,-17572,1809,48707,62270,2025-06-19
IMOEXF,Количество лиц,8427,2447,25,37,10936,2025-06-19
SBER,Открытые позиции,105696,29460,179716,255952,570824,2025-06-19
SBER,Изменение,-20997,-6855,23214,9072,4434,2025-06-19
SBER,Количество лиц,3594,916,69,29,4608,2025-06-19
GAZP,Открытые позиции,206104,56148,755278,905234,1922764,2025-06-19
GAZP,Изменение,-28396,-5519,258556,235679,460320,2025-06-19
GAZP,Количество лиц,3365,899,37,89,4390,2025-06-19
SMLT,Открытые позиции,177255,34992,62893,205156,480296,2025-06-19
SMLT,Изменение,-7655,-3923,3325,-407,-8660,2025-06-19
SMLT,Количество лиц,899,281,11,31,1222,2025-06-19
GMKN,Открытые позиции,422231,47779,206823,581275,1258108,2025-06-19
GMKN,Изменение,-26966,-11179,26878,11091,-176,2025-06-19
GMKN,Количество лиц,1940,333,16,51,2340,2025-06-19
YDEX,Открытые позиции,118204,17488,24394,125110,285196,2025-06-19
YDEX,Изменение,-21364,-1961,3902,-15501,-34924,2025-06-19
YDEX,Количество лиц,1293,201,15,50,1559,2025-06-19
MGNT,Открытые позиции,156541,7596,47277,196222,407636,2025-06-19
MGNT,Изменение,-6410,-2019,13426,9035,14032,2025-06-19
MGNT,Количество лиц,1384,185,20,38,1627,2025-06-19
ABIO,Открытые позиции,2538,463,1595,3670,8266,2025-06-19
ABIO,Изменение,-84,-33,172,121,176,2025-06-19
ABIO,Количество лиц,80,13,3,5,101,2025-06-19
VTBR,Открытые позиции,182228,27007,85376,240597,535208,2025-06-19
VTBR,Изменение,-10089,-4830,16180,10921,12182,2025-06-19
VTBR,Количество лиц,2367,433,25,19,2844,2025-06-19
SGZH,Открытые позиции,44553,45905,2855,1503,94816,2025-06-19
SGZH,Изменение,-2869,-2548,-309,-630,-6356,2025-06-19
SGZH,Количество лиц,360,207,5,5,577,2025-06-19
TRNFP,Открытые позиции,66128,47846,137793,156075,407842,2025-06-19
TRNFP,Изменение,-51424,2245,44239,-9430,-14370,2025-06-19
TRNFP,Количество лиц,613,166,11,6,796,2025-06-19
WUSH,Открытые позиции,52137,6934,23253,68456,150780,2025-06-19
WUSH,Изменение,-3076,-1588,4063,2575,1974,2025-06-19
WUSH,Количество лиц,550,153,17,23,743,2025-06-19
VKCO,Открытые позиции,51205,15074,22910,59041,148230,2025-06-19
VKCO,Изменение,-3764,-492,3643,371,-242,2025-06-19
VKCO,Количество лиц,695,201,11,23,930,2025-06-19
BABA,Открытые позиции,21367,13278,0,8089,42734,2025-06-19
BABA,Изменение,900,-1185,-14,2071,1772,2025-06-19
BABA,Количество лиц,340,67,0,4,411,2025-06-19
BIDU,Открытые позиции,35312,10093,0,25219,70624,2025-06-19
BIDU,Изменение,2570,-69,-20,2619,5100,2025-06-19
BIDU,Количество лиц,175,36,0,4,215,2025-06-19
SIBN,Открытые позиции,12645,1933,11753,22465,48796,2025-06-19
SIBN,Изменение,-1337,-161,3209,2033,3744,2025-06-19
SIBN,Количество лиц,401,87,13,12,513,2025-06-19
RNFT,Открытые позиции,39169,21089,6615,24695,91568,2025-06-19
RNFT,Изменение,-9743,-981,3350,-5412,-12786,2025-06-19
RNFT,Количество лиц,274,228,2,10,514,2025-06-19
MVID,Открытые позиции,11939,15540,8270,4669,40418,2025-06-19
MVID,Изменение,1315,-37,793,2145,4216,2025-06-19
MVID,Количество лиц,136,108,3,9,256,2025-06-19
PIKK,Открытые позиции,30561,21255,17689,26995,96500,2025-06-19
PIKK,Изменение,-3617,-2724,1793,900,-3648,2025-06-19
PIKK,Количество лиц,528,461,11,20,1020,2025-06-19
BELU,Открытые позиции,47925,28860,1865,20930,99580,2025-06-19
BELU,Изменение,268,-400,343,1011,1222,2025-06-19
BELU,Количество лиц,299,75,3,17,394,2025-06-19
MTLR,Открытые позиции,11314,16969,10537,4882,43702,2025-06-19
MTLR,Изменение,-991,387,658,-720,-666,2025-06-19
MTLR,Количество лиц,368,288,9,7,672,2025-06-19
POSI,Открытые позиции,79610,15903,1045,64752,161310,2025-06-19
POSI,Изменение,-7289,-981,-244,-6552,-15066,2025-06-19
POSI,Количество лиц,612,171,6,20,809,2025-06-19
ASTR,Открытые позиции,53230,13132,22288,62386,151036,2025-06-19
ASTR,Изменение,4056,-1090,4774,9920,17660,2025-06-19
ASTR,Количество лиц,342,93,5,16,456,2025-06-19
SOFL,Открытые позиции,25343,4322,5375,26396,61436,2025-06-19
SOFL,Изменение,2613,1645,4245,5213,13716,2025-06-19
SOFL,Количество лиц,147,44,5,8,204,2025-06-19
ALRS,Открытые позиции,24145,3955,73165,93355,194620,2025-06-19
ALRS,Изменение,-4670,76,4759,13,178,2025-06-19
ALRS,Количество лиц,504,175,16,29,724,2025-06-19
NLMK,Открытые позиции,23286,5302,6649,24633,59870,2025-06-19
NLMK,Изменение,-2101,-171,2415,485,628,2025-06-19
NLMK,Количество лиц,512,115,10,41,678,2025-06-19
AFLT,Открытые позиции,21234,11379,1222,11077,44912,2025-06-19
AFLT,Изменение,-2004,-699,765,-540,-2478,2025-06-19
AFLT,Количество лиц,580,186,7,22,795,2025-06-19
BANE,Открытые позиции,4217,3104,1279,2392,10992,2025-06-19
BANE,Изменение,-835,-35,-39,-839,-1748,2025-06-19
BANE,Количество лиц,162,59,4,10,235,2025-06-19
RUAL,Открытые позиции,26605,2532,14813,38886,82836,2025-06-19
RUAL,Изменение,-1615,-1271,3741,3397,4252,2025-06-19
RUAL,Количество лиц,457,82,8,18,565,2025-06-19
LEAS,Открытые позиции,36387,10095,10,26302,72794,2025-06-19
LEAS,Изменение,-3836,-3385,-416,-867,-8504,2025-06-19
LEAS,Количество лиц,228,72,1,13,314,2025-06-19
AFKS,Открытые позиции,4558,8020,4760,1298,18636,2025-06-19
AFKS,Изменение,-732,-110,553,-69,-358,2025-06-19
AFKS,Количество лиц,307,186,8,18,519,2025-06-19
RTKM,Открытые позиции,14645,2963,13054,24736,55398,2025-06-19
RTKM,Изменение,-3643,-438,3370,165,-546,2025-06-19
RTKM,Количество лиц,345,74,14,9,442,2025-06-19
SFIN,Открытые позиции,12660,8205,2950,7405,31220,2025-06-19
SFIN,Изменение,966,-538,-310,1194,1312,2025-06-19
SFIN,Количество лиц,173,33,1,16,223,2025-06-19
MOEX,Открытые позиции,13445,3425,12553,22573,51996,2025-06-19
MOEX,Изменение,-738,92,626,-204,-224,2025-06-19
MOEX,Количество лиц,680,132,16,12,840,2025-06-19
SBERP,Открытые позиции,7957,1751,6116,12322,28146,2025-06-19
SBERP,Изменение,-706,131,623,-214,-166,2025-06-19
SBERP,Количество лиц,483,113,9,20,625,2025-06-19
ROSN,Открытые позиции,7382,3353,14590,18619,43944,2025-06-19
ROSN,Изменение,-821,-191,1404,774,1166,2025-06-19
ROSN,Количество лиц,829,265,19,23,1136,2025-06-19
FESH,Открытые позиции,3551,2344,351,1558,7804,2025-06-19
FESH,Изменение,153,-327,-41,439,224,2025-06-19
FESH,Количество лиц,75,78,4,16,173,2025-06-19
PHOR,Открытые позиции,4403,4299,7663,7767,24132,2025-06-19
PHOR,Изменение,-129,-368,-24,215,-306,2025-06-19
PHOR,Количество лиц,231,84,10,12,337,2025-06-19
SVCB,Открытые позиции,52197,5476,457,47178,105308,2025-06-19
SVCB,Изменение,-1658,659,-204,-2521,-3724,2025-06-19
SVCB,Количество лиц,340,79,2,12,433,2025-06-19
CBOM,Открытые позиции,1751,12494,11246,503,25994,2025-06-19
CBOM,Изменение,-317,-2761,-2212,232,-5058,2025-06-19
CBOM,Количество лиц,92,49,8,8,157,2025-06-19
LKOH,Открытые позиции,10972,9063,52677,54586,127298,2025-06-19
LKOH,Изменение,-1462,-583,1104,225,-716,2025-06-19
LKOH,Количество лиц,890,367,17,44,1318,2025-06-19
KMAZ,Открытые позиции,7469,3934,2554,6089,20046,2025-06-19
KMAZ,Изменение,-1181,-874,382,75,-1598,2025-06-19
KMAZ,Количество лиц,137,47,7,8,199,2025-06-19
SNGS,Открытые позиции,7911,1100,9325,16136,34472,2025-06-19
SNGS,Изменение,-1404,62,3642,2176,4476,2025-06-19
SNGS,Количество лиц,362,57,17,22,458,2025-06-19
HYDR,Открытые позиции,5371,2050,7408,10729,25558,2025-06-19
HYDR,Изменение,-2183,-745,1599,161,-1168,2025-06-19
HYDR,Количество лиц,182,60,12,8,262,2025-06-19
NVTK,Открытые позиции,3592,446,2522,5668,12228,2025-06-19
NVTK,Изменение,-1026,52,1384,306,716,2025-06-19
NVTK,Количество лиц,552,114,17,29,712,2025-06-19
FEES,Открытые позиции,4892,521,943,5314,11670,2025-06-19
FEES,Изменение,-576,-99,396,-81,-360,2025-06-19
FEES,Количество лиц,141,48,4,11,204,2025-06-19
MAGN,Открытые позиции,1809,657,589,1741,4796,2025-06-19
MAGN,Изменение,-717,-50,118,-549,-1198,2025-06-19
MAGN,Количество лиц,266,66,7,15,354,2025-06-19
BSPB,Открытые позиции,8750,7178,1314,2886,20128,2025-06-19
BSPB,Изменение,-1436,-1236,565,365,-1742,2025-06-19
BSPB,Количество лиц,225,137,5,12,379,2025-06-19
TATN,Открытые позиции,1171,2441,6195,4925,14732,2025-06-19
TATN,Изменение,-178,111,6,-283,-344,2025-06-19
TATN,Количество лиц,194,119,6,18,337,2025-06-19
FLOT,Открытые позиции,6445,2300,1086,5231,15062,2025-06-19
FLOT,Изменение,-59,-434,-20,355,-158,2025-06-19
FLOT,Количество лиц,196,110,3,13,322,2025-06-19
MTSS,Открытые позиции,3113,1889,10622,11846,27470,2025-06-19
MTSS,Изменение,471,267,632,836,2206,2025-06-19
MTSS,Количество лиц,245,102,11,13,371,2025-06-19
TATNP,Открытые позиции,1479,1302,767,944,4492,2025-06-19
TATNP,Изменение,-112,-1,107,-4,-10,2025-06-19
TATNP,Количество лиц,122,48,4,8,182,2025-06-19
CHMF,Открытые позиции,821,254,1254,1821,4150,2025-06-19
CHMF,Изменение,-411,-39,448,76,74,2025-06-19
CHMF,Количество лиц,160,52,19,10,241,2025-06-19
RASP,Открытые позиции,7060,2837,533,4756,15186,2025-06-19
RASP,Изменение,34,-149,53,236,174,2025-06-19
RASP,Количество лиц,134,46,3,9,192,2025-06-19
IRAO,Открытые позиции,2239,1468,7114,7885,18706,2025-06-19
IRAO,Изменение,-158,-128,-11515,-11545,-23346,2025-06-19
IRAO,Количество лиц,246,82,5,17,350,2025-06-19
SNGSP,Открытые позиции,3782,672,3952,7062,15468,2025-06-19
SNGSP,Изменение,-548,-3,676,131,256,2025-06-19
SNGSP,Количество лиц,325,55,16,9,405,2025-06-19
PLZL,Открытые позиции,417,288,1052,1181,2938,2025-06-19
PLZL,Изменение,-369,-11,110,-248,-518,2025-06-19
PLZL,Количество лиц,141,70,10,12,233,2025-06-19
SPBE,Открытые позиции,29389,6316,3504,26577,65786,2025-06-19
SPBE,Изменение,-4703,-1401,9,-3293,-9388,2025-06-19
SPBE,Количество лиц,558,87,4,21,670,2025-06-19
