Contract Code,Metric,Value1,Value2,Value3,Value4,Value5,Date
IMOEXF,Открытые позиции,516563,296353,37627,257837,1108380,2025-06-21
IMOEXF,Изменение,9354,8818,-98,438,18512,2025-06-21
IMOEXF,Количество лиц,8387,2500,24,36,10947,2025-06-21
SBER,Открытые позиции,94383,30918,49003,112468,286772,2025-06-21
SBER,Изменение,-7996,6344,-142207,-156547,-300406,2025-06-21
SBER,Количество лиц,2369,1208,43,32,3652,2025-06-21
GAZP,Открытые позиции,166764,51381,392187,507570,1117902,2025-06-21
GAZP,Изменение,-17075,3727,-390407,-411209,-814964,2025-06-21
GAZP,Количество лиц,2194,963,17,66,3240,2025-06-21
SMLT,Открытые позиции,124078,28815,1,95264,248158,2025-06-21
SMLT,Изменение,-22420,-5281,-103954,-121093,-252748,2025-06-21
SMLT,Количество лиц,588,190,1,41,820,2025-06-21
GMKN,Открытые позиции,328313,54619,88491,362185,833608,2025-06-21
GMKN,Изменение,-50949,-5105,-193909,-239753,-489716,2025-06-21
GMKN,Количество лиц,1304,462,4,42,1812,2025-06-21
YDEX,Открытые позиции,82269,13567,1041,69743,166620,2025-06-21
YDEX,Изменение,-15794,-6180,-43035,-52649,-117658,2025-06-21
YDEX,Количество лиц,718,325,8,37,1088,2025-06-21
MGNT,Открытые позиции,80127,9820,2501,72808,165256,2025-06-21
MGNT,Изменение,-58323,3137,-61636,-123096,-239918,2025-06-21
MGNT,Количество лиц,948,177,5,17,1147,2025-06-21
ABIO,Открытые позиции,720,55,0,665,1440,2025-06-21
ABIO,Изменение,-1623,-283,-1724,-3064,-6694,2025-06-21
ABIO,Количество лиц,42,9,0,6,57,2025-06-21
VTBR,Открытые позиции,151139,35036,35187,151290,372652,2025-06-21
VTBR,Изменение,-29999,1419,-84920,-116338,-229838,2025-06-21
VTBR,Количество лиц,1812,558,6,15,2391,2025-06-21
SGZH,Открытые позиции,21028,23045,2190,173,46436,2025-06-21
SGZH,Изменение,-12655,-13292,-1198,-561,-27706,2025-06-21
SGZH,Количество лиц,166,118,4,4,292,2025-06-21
TRNFP,Открытые позиции,53552,29792,73206,96966,253516,2025-06-21
TRNFP,Изменение,-5989,-17309,-74746,-63426,-161470,2025-06-21
TRNFP,Количество лиц,429,148,2,2,581,2025-06-21
WUSH,Открытые позиции,31214,6427,0,24787,62428,2025-06-21
WUSH,Изменение,-13504,-542,-33195,-46157,-93398,2025-06-21
WUSH,Количество лиц,280,143,0,23,446,2025-06-21
VKCO,Открытые позиции,40207,9750,2487,32944,85388,2025-06-21
VKCO,Изменение,-7779,-3257,-27247,-31769,-70052,2025-06-21
VKCO,Количество лиц,441,162,1,25,629,2025-06-21
BABA,Открытые позиции,10264,3125,0,7139,20528,2025-06-21
BABA,Изменение,-12067,-10311,0,-1756,-24134,2025-06-21
BABA,Количество лиц,168,46,0,3,217,2025-06-21
BIDU,Открытые позиции,19262,1367,0,17895,38524,2025-06-21
BIDU,Изменение,-16268,-8084,0,-8184,-32536,2025-06-21
BIDU,Количество лиц,87,24,0,4,115,2025-06-21
SIBN,Открытые позиции,7358,1708,1071,6721,16858,2025-06-21
SIBN,Изменение,-2198,-47,-13566,-15717,-31528,2025-06-21
SIBN,Количество лиц,213,69,1,14,297,2025-06-21
RNFT,Открытые позиции,13365,16030,3732,1067,34194,2025-06-21
RNFT,Изменение,-17351,-2069,-3428,-18710,-41558,2025-06-21
RNFT,Количество лиц,159,163,4,6,332,2025-06-21
MVID,Открытые позиции,7527,10783,3315,59,21684,2025-06-21
MVID,Изменение,-2763,-2217,-4473,-5019,-14472,2025-06-21
MVID,Количество лиц,63,85,2,1,151,2025-06-21
PIKK,Открытые позиции,16753,10159,83,6677,33672,2025-06-21
PIKK,Изменение,-6981,-7854,-18449,-17576,-50860,2025-06-21
PIKK,Количество лиц,382,286,1,24,693,2025-06-21
BELU,Открытые позиции,22923,7422,0,15501,45846,2025-06-21
BELU,Изменение,-14209,-21846,-8717,-1080,-45852,2025-06-21
BELU,Количество лиц,150,48,0,17,215,2025-06-21
MTLR,Открытые позиции,5657,11995,6690,352,24694,2025-06-21
MTLR,Изменение,-2974,-3233,-4310,-4051,-14568,2025-06-21
MTLR,Количество лиц,257,244,7,6,514,2025-06-21
POSI,Открытые позиции,58903,15411,8,43500,117822,2025-06-21
POSI,Изменение,-12148,-369,-3872,-15651,-32040,2025-06-21
POSI,Количество лиц,420,138,1,25,584,2025-06-21
ASTR,Открытые позиции,34840,11597,245,23488,70170,2025-06-21
ASTR,Изменение,-16050,-1089,-26282,-41243,-84664,2025-06-21
ASTR,Количество лиц,180,61,1,16,258,2025-06-21
SOFL,Открытые позиции,14230,3707,0,10523,28460,2025-06-21
SOFL,Изменение,-8265,-47,-8343,-16561,-33216,2025-06-21
SOFL,Количество лиц,70,33,0,8,111,2025-06-21
ALRS,Открытые позиции,16655,3111,36614,50158,106538,2025-06-21
ALRS,Изменение,-3876,-623,-40736,-43989,-89224,2025-06-21
ALRS,Количество лиц,359,136,4,21,520,2025-06-21
NLMK,Открытые позиции,19799,2119,2931,20611,45460,2025-06-21
NLMK,Изменение,-2907,-3418,-4352,-3841,-14518,2025-06-21
NLMK,Количество лиц,388,95,5,25,513,2025-06-21
AFLT,Открытые позиции,15553,9673,41,5921,31188,2025-06-21
AFLT,Изменение,-3514,-1383,-2488,-4619,-12004,2025-06-21
AFLT,Количество лиц,407,130,1,11,549,2025-06-21
BANE,Открытые позиции,2563,1568,36,1031,5198,2025-06-21
BANE,Изменение,-1397,3,-1149,-2549,-5092,2025-06-21
BANE,Количество лиц,94,59,2,5,160,2025-06-21
RUAL,Открытые позиции,16873,2031,115,14957,33976,2025-06-21
RUAL,Изменение,-6747,-49,-16501,-23199,-46496,2025-06-21
RUAL,Количество лиц,285,66,1,17,369,2025-06-21
LEAS,Открытые позиции,18122,2802,1619,16939,39482,2025-06-21
LEAS,Изменение,-6710,-6576,-75,-209,-13570,2025-06-21
LEAS,Количество лиц,130,39,2,12,183,2025-06-21
AFKS,Открытые позиции,2608,3570,1018,56,7252,2025-06-21
AFKS,Изменение,-1400,-354,-3958,-5004,-10716,2025-06-21
AFKS,Количество лиц,211,160,5,5,381,2025-06-21
RTKM,Открытые позиции,7378,3002,4464,8840,23684,2025-06-21
RTKM,Изменение,-7462,-737,-11810,-18535,-38544,2025-06-21
RTKM,Количество лиц,244,64,2,13,323,2025-06-21
SFIN,Открытые позиции,5665,828,0,4837,11330,2025-06-21
SFIN,Изменение,-3695,-7316,-3071,550,-13532,2025-06-21
SFIN,Количество лиц,87,22,0,12,121,2025-06-21
MOEX,Открытые позиции,6583,2520,8630,12693,30426,2025-06-21
MOEX,Изменение,-3961,-1209,-8289,-11041,-24500,2025-06-21
MOEX,Количество лиц,364,142,8,5,519,2025-06-21
SBERP,Открытые позиции,7442,1670,1109,6881,17102,2025-06-21
SBERP,Изменение,-220,36,-5729,-5985,-11898,2025-06-21
SBERP,Количество лиц,347,85,4,4,440,2025-06-21
ROSN,Открытые позиции,4736,2957,8056,9835,25584,2025-06-21
ROSN,Изменение,-1248,-281,-8430,-9397,-19356,2025-06-21
ROSN,Количество лиц,513,290,11,13,827,2025-06-21
FESH,Открытые позиции,2848,1091,0,1757,5696,2025-06-21
FESH,Изменение,-941,-689,-280,-532,-2442,2025-06-21
FESH,Количество лиц,72,39,0,13,124,2025-06-21
PHOR,Открытые позиции,2913,1838,41,1116,5908,2025-06-21
PHOR,Изменение,-1058,-1340,-7184,-6902,-16484,2025-06-21
PHOR,Количество лиц,140,63,1,6,210,2025-06-21
SVCB,Открытые позиции,26107,8890,2,17219,52218,2025-06-21
SVCB,Изменение,-20028,1608,-6850,-28486,-53756,2025-06-21
SVCB,Количество лиц,216,70,1,9,296,2025-06-21
CBOM,Открытые позиции,1568,5249,3706,25,10548,2025-06-21
CBOM,Изменение,-294,-6607,-7167,-854,-14922,2025-06-21
CBOM,Количество лиц,65,37,5,2,109,2025-06-21
LKOH,Открытые позиции,8478,1479,579,7578,18114,2025-06-21
LKOH,Изменение,-1184,-7174,-52938,-46948,-108244,2025-06-21
LKOH,Количество лиц,549,227,5,26,807,2025-06-21
KMAZ,Открытые позиции,3076,1796,2,1282,6156,2025-06-21
KMAZ,Изменение,-4065,-132,-2115,-6048,-12360,2025-06-21
KMAZ,Количество лиц,55,45,1,10,111,2025-06-21
SNGS,Открытые позиции,4749,987,5207,8969,19912,2025-06-21
SNGS,Изменение,-2356,-137,-8498,-10717,-21708,2025-06-21
SNGS,Количество лиц,259,42,5,14,320,2025-06-21
HYDR,Открытые позиции,3593,2004,4675,6264,16536,2025-06-21
HYDR,Изменение,-1267,-157,-4230,-5340,-10994,2025-06-21
HYDR,Количество лиц,134,58,1,6,199,2025-06-21
NVTK,Открытые позиции,2815,407,527,2935,6684,2025-06-21
NVTK,Изменение,-257,-4,-3435,-3688,-7384,2025-06-21
NVTK,Количество лиц,360,89,4,31,484,2025-06-21
FEES,Открытые позиции,2631,483,0,2148,5262,2025-06-21
FEES,Изменение,-2026,-14,-1032,-3044,-6116,2025-06-21
FEES,Количество лиц,114,35,0,11,160,2025-06-21
MAGN,Открытые позиции,1162,602,25,585,2374,2025-06-21
MAGN,Изменение,-395,-79,-707,-1023,-2204,2025-06-21
MAGN,Количество лиц,176,53,2,7,238,2025-06-21
BSPB,Открытые позиции,4803,5451,1478,830,12562,2025-06-21
BSPB,Изменение,-1291,-1823,-851,-319,-4284,2025-06-21
BSPB,Количество лиц,125,118,4,2,249,2025-06-21
TATN,Открытые позиции,960,1836,921,45,3762,2025-06-21
TATN,Изменение,-135,-480,-5243,-4898,-10756,2025-06-21
TATN,Количество лиц,94,89,5,6,194,2025-06-21
FLOT,Открытые позиции,2650,1930,54,774,5408,2025-06-21
FLOT,Изменение,-3034,-66,-1081,-4049,-8230,2025-06-21
FLOT,Количество лиц,101,93,2,12,208,2025-06-21
MTSS,Открытые позиции,2583,1754,12202,13031,29570,2025-06-21
MTSS,Изменение,-642,-68,-1883,-2457,-5050,2025-06-21
MTSS,Количество лиц,172,81,5,3,261,2025-06-21
TATNP,Открытые позиции,498,332,56,222,1108,2025-06-21
TATNP,Изменение,-360,-854,-1090,-596,-2900,2025-06-21
TATNP,Количество лиц,58,31,2,5,96,2025-06-21
CHMF,Открытые позиции,519,195,409,733,1856,2025-06-21
CHMF,Изменение,-160,-22,-1401,-1539,-3122,2025-06-21
CHMF,Количество лиц,105,47,4,14,170,2025-06-21
RASP,Открытые позиции,2492,2440,73,125,5130,2025-06-21
RASP,Изменение,-3188,-31,-396,-3553,-7168,2025-06-21
RASP,Количество лиц,82,32,2,5,121,2025-06-21
IRAO,Открытые позиции,1149,118,766,1797,3830,2025-06-21
IRAO,Изменение,-847,-1327,-6315,-5835,-14324,2025-06-21
IRAO,Количество лиц,174,31,2,12,219,2025-06-21
SNGSP,Открытые позиции,1961,181,3025,4805,9972,2025-06-21
SNGSP,Изменение,-1513,-507,-1439,-2445,-5904,2025-06-21
SNGSP,Количество лиц,192,45,4,3,244,2025-06-21
PLZL,Открытые позиции,224,175,16,65,480,2025-06-21
PLZL,Изменение,-110,-90,-1013,-1033,-2246,2025-06-21
PLZL,Количество лиц,89,49,3,4,145,2025-06-21
SPBE,Открытые позиции,12623,7004,330,5949,25906,2025-06-21
SPBE,Изменение,-11919,458,-6062,-18439,-35962,2025-06-21
SPBE,Количество лиц,315,91,1,20,427,2025-06-21
