Contract Code,Metric,Value1,Value2,Value3,Value4,Value5,Date
IMOEXF,Открытые позиции,397726,246084,62383,214025,920218,2025-04-25
IMOEXF,Изменение,-13673,-14661,-7444,-6456,-42234,2025-04-25
IMOEXF,Количество лиц,6812,2947,37,36,9832,2025-04-25
SBER,Открытые позиции,103411,42720,87961,148652,382744,2025-04-25
SBER,Изменение,-5494,1324,1485,-5333,-8018,2025-04-25
SBER,Количество лиц,3726,1260,44,70,5100,2025-04-25
GAZP,Открытые позиции,193692,31604,292345,454433,972074,2025-04-25
GAZP,Изменение,10262,1461,-796,8005,18932,2025-04-25
GAZP,Количество лиц,3175,1156,18,96,4445,2025-04-25
SMLT,Открытые позиции,172177,33950,1532,139759,347418,2025-04-25
SMLT,Изменение,7347,2888,-2076,2383,10542,2025-04-25
SMLT,Количество лиц,917,321,4,14,1256,2025-04-25
GMKN,Открытые позиции,380700,32176,169681,518205,1100762,2025-04-25
GMKN,Изменение,34831,-49808,-1539,83100,66584,2025-04-25
GMKN,Количество лиц,1684,271,13,69,2037,2025-04-25
YDEX,Открытые позиции,125838,33269,4552,97121,260780,2025-04-25
YDEX,Изменение,11347,-11920,-7462,15805,7770,2025-04-25
YDEX,Количество лиц,1364,308,6,30,1708,2025-04-25
MGNT,Открытые позиции,85146,5780,2331,81697,174954,2025-04-25
MGNT,Изменение,518,-106,-127,497,782,2025-04-25
MGNT,Количество лиц,1217,171,4,23,1415,2025-04-25
ABIO,Открытые позиции,3215,369,421,3267,7272,2025-04-25
ABIO,Изменение,16,5,0,11,32,2025-04-25
ABIO,Количество лиц,70,11,2,3,86,2025-04-25
VTBR,Открытые позиции,138734,34561,21347,125520,320162,2025-04-25
VTBR,Изменение,-3779,-5495,-6468,-4752,-20494,2025-04-25
VTBR,Количество лиц,2120,791,18,31,2960,2025-04-25
SGZH,Открытые позиции,65737,56931,9805,18611,151084,2025-04-25
SGZH,Изменение,2630,-7969,6319,16918,17898,2025-04-25
SGZH,Количество лиц,598,230,7,2,837,2025-04-25
TRNFP,Открытые позиции,121474,24897,4439,101016,251826,2025-04-25
TRNFP,Изменение,2850,370,0,2480,5700,2025-04-25
TRNFP,Количество лиц,771,137,2,42,952,2025-04-25
WUSH,Открытые позиции,53230,4284,1625,50571,109710,2025-04-25
WUSH,Изменение,2945,246,-1796,903,2298,2025-04-25
WUSH,Количество лиц,633,119,4,12,768,2025-04-25
VKCO,Открытые позиции,66968,20695,1346,47619,136628,2025-04-25
VKCO,Изменение,1277,113,7,1171,2568,2025-04-25
VKCO,Количество лиц,744,255,3,30,1032,2025-04-25
BABA,Открытые позиции,37102,5910,301,31493,74806,2025-04-25
BABA,Изменение,429,612,0,-183,858,2025-04-25
BABA,Количество лиц,373,119,3,3,498,2025-04-25
BIDU,Открытые позиции,29953,1845,1,28109,59908,2025-04-25
BIDU,Изменение,200,-55,0,255,400,2025-04-25
BIDU,Количество лиц,190,40,1,4,235,2025-04-25
SIBN,Открытые позиции,23247,2937,1573,21883,49640,2025-04-25
SIBN,Изменение,544,-708,-73,1179,942,2025-04-25
SIBN,Количество лиц,614,96,6,27,743,2025-04-25
RNFT,Открытые позиции,48528,22872,59,25715,97174,2025-04-25
RNFT,Изменение,-2848,574,-1,-3423,-5698,2025-04-25
RNFT,Количество лиц,365,170,1,22,558,2025-04-25
MVID,Открытые позиции,9433,9157,843,1119,20552,2025-04-25
MVID,Изменение,-238,-1373,-353,782,-1182,2025-04-25
MVID,Количество лиц,123,113,2,6,244,2025-04-25
PIKK,Открытые позиции,44434,14001,2209,32642,93286,2025-04-25
PIKK,Изменение,-7421,3279,1443,-9257,-11956,2025-04-25
PIKK,Количество лиц,698,335,6,37,1076,2025-04-25
BELU,Открытые позиции,39573,31861,155,7867,79456,2025-04-25
BELU,Изменение,979,-455,-389,1045,1180,2025-04-25
BELU,Количество лиц,301,70,2,8,381,2025-04-25
MTLR,Открытые позиции,12352,18262,9498,3588,43700,2025-04-25
MTLR,Изменение,626,351,-285,-10,682,2025-04-25
MTLR,Количество лиц,443,298,9,4,754,2025-04-25
POSI,Открытые позиции,81909,34973,10,46946,163838,2025-04-25
POSI,Изменение,-3687,1,-36,-3724,-7446,2025-04-25
POSI,Количество лиц,690,197,1,28,916,2025-04-25
ASTR,Открытые позиции,79243,20627,557,59173,159600,2025-04-25
ASTR,Изменение,789,33,-70,686,1438,2025-04-25
ASTR,Количество лиц,440,105,1,16,562,2025-04-25
SOFL,Открытые позиции,27128,2534,59,24653,54374,2025-04-25
SOFL,Изменение,563,262,0,301,1126,2025-04-25
SOFL,Количество лиц,187,50,1,14,252,2025-04-25
ALRS,Открытые позиции,20968,3295,80981,98654,203898,2025-04-25
ALRS,Изменение,143,155,-79,-91,128,2025-04-25
ALRS,Количество лиц,563,174,5,59,801,2025-04-25
NLMK,Открытые позиции,18673,5474,4489,17688,46324,2025-04-25
NLMK,Изменение,674,69,-2,603,1344,2025-04-25
NLMK,Количество лиц,491,124,5,21,641,2025-04-25
AFLT,Открытые позиции,25829,13985,83,11927,51824,2025-04-25
AFLT,Изменение,216,-251,-711,-244,-990,2025-04-25
AFLT,Количество лиц,693,268,4,33,998,2025-04-25
BANE,Открытые позиции,5683,4284,584,1983,12534,2025-04-25
BANE,Изменение,3,76,-137,-210,-268,2025-04-25
BANE,Количество лиц,173,65,3,13,254,2025-04-25
RUAL,Открытые позиции,24200,3946,1856,22110,52112,2025-04-25
RUAL,Изменение,-418,62,-151,-631,-1138,2025-04-25
RUAL,Количество лиц,465,90,4,19,578,2025-04-25
LEAS,Открытые позиции,45258,46448,2664,1474,95844,2025-04-25
LEAS,Изменение,2994,1968,-1003,23,3982,2025-04-25
LEAS,Количество лиц,264,93,3,6,366,2025-04-25
AFKS,Открытые позиции,5699,5036,2057,2720,15512,2025-04-25
AFKS,Изменение,184,62,-128,-6,112,2025-04-25
AFKS,Количество лиц,361,211,5,14,591,2025-04-25
RTKM,Открытые позиции,16591,11084,5275,10782,43732,2025-04-25
RTKM,Изменение,-128,-89,-221,-260,-698,2025-04-25
RTKM,Количество лиц,368,122,4,16,510,2025-04-25
SFIN,Открытые позиции,14395,9589,500,5306,29790,2025-04-25
SFIN,Изменение,512,1855,0,-1343,1024,2025-04-25
SFIN,Количество лиц,198,53,1,7,259,2025-04-25
MOEX,Открытые позиции,18424,5084,8377,21717,53602,2025-04-25
MOEX,Изменение,337,664,3542,3215,7758,2025-04-25
MOEX,Количество лиц,971,228,8,15,1222,2025-04-25
SBERP,Открытые позиции,7442,756,2748,9434,20380,2025-04-25
SBERP,Изменение,108,1,-31,76,154,2025-04-25
SBERP,Количество лиц,451,109,4,26,590,2025-04-25
ROSN,Открытые позиции,7509,1895,13778,19392,42574,2025-04-25
ROSN,Изменение,26,232,301,95,654,2025-04-25
ROSN,Количество лиц,872,225,13,23,1133,2025-04-25
FESH,Открытые позиции,4978,769,0,4209,9956,2025-04-25
FESH,Изменение,42,-300,0,342,84,2025-04-25
FESH,Количество лиц,103,65,0,16,184,2025-04-25
PHOR,Открытые позиции,22925,3949,482,19458,46814,2025-04-25
PHOR,Изменение,-82,-32,-29,-79,-222,2025-04-25
PHOR,Количество лиц,313,94,4,17,428,2025-04-25
SVCB,Открытые позиции,50449,12931,438,37956,101774,2025-04-25
SVCB,Изменение,2468,553,-980,935,2976,2025-04-25
SVCB,Количество лиц,420,70,2,9,501,2025-04-25
CBOM,Открытые позиции,925,2693,2564,796,6978,2025-04-25
CBOM,Изменение,46,-8,-5,49,82,2025-04-25
CBOM,Количество лиц,67,64,1,6,138,2025-04-25
LKOH,Открытые позиции,9776,5038,49456,54194,118464,2025-04-25
LKOH,Изменение,-9,119,200,72,382,2025-04-25
LKOH,Количество лиц,1133,304,13,12,1462,2025-04-25
KMAZ,Открытые позиции,10493,4188,395,6700,21776,2025-04-25
KMAZ,Изменение,284,948,252,-412,1072,2025-04-25
KMAZ,Количество лиц,158,62,4,9,233,2025-04-25
SNGS,Открытые позиции,10040,1172,1629,10497,23338,2025-04-25
SNGS,Изменение,-64,109,-8,-181,-144,2025-04-25
SNGS,Количество лиц,422,75,5,21,523,2025-04-25
HYDR,Открытые позиции,9692,1601,263,8354,19910,2025-04-25
HYDR,Изменение,-288,-92,-4,-200,-584,2025-04-25
HYDR,Количество лиц,219,55,2,14,290,2025-04-25
NVTK,Открытые позиции,3664,1684,1432,3412,10192,2025-04-25
NVTK,Изменение,-63,47,98,-12,70,2025-04-25
NVTK,Количество лиц,569,265,6,13,853,2025-04-25
FEES,Открытые позиции,4590,766,82,3906,9344,2025-04-25
FEES,Изменение,113,-22,50,185,326,2025-04-25
FEES,Количество лиц,159,41,1,10,211,2025-04-25
MAGN,Открытые позиции,2990,569,1076,3497,8132,2025-04-25
MAGN,Изменение,-80,57,119,-18,78,2025-04-25
MAGN,Количество лиц,294,82,8,4,388,2025-04-25
BSPB,Открытые позиции,8104,6074,625,2655,17458,2025-04-25
BSPB,Изменение,-49,-126,-1,76,-100,2025-04-25
BSPB,Количество лиц,245,143,3,5,396,2025-04-25
TATN,Открытые позиции,1582,1249,4221,4554,11606,2025-04-25
TATN,Изменение,-33,-26,-2,-9,-70,2025-04-25
TATN,Количество лиц,281,109,8,6,404,2025-04-25
FLOT,Открытые позиции,6481,1231,92,5342,13146,2025-04-25
FLOT,Изменение,-169,-21,8,-140,-322,2025-04-25
FLOT,Количество лиц,271,79,4,16,370,2025-04-25
MTSS,Открытые позиции,3313,1063,1627,3877,9880,2025-04-25
MTSS,Изменение,35,61,-7,-33,56,2025-04-25
MTSS,Количество лиц,249,103,5,26,383,2025-04-25
TATNP,Открытые позиции,1931,945,377,1363,4616,2025-04-25
TATNP,Изменение,15,-6,-12,9,6,2025-04-25
TATNP,Количество лиц,154,42,3,6,205,2025-04-25
CHMF,Открытые позиции,1374,273,466,1567,3680,2025-04-25
CHMF,Изменение,-10,-5,-5,-10,-30,2025-04-25
CHMF,Количество лиц,189,68,10,23,290,2025-04-25
RASP,Открытые позиции,7468,7107,947,1308,16830,2025-04-25
RASP,Изменение,54,-28,5,87,118,2025-04-25
RASP,Количество лиц,101,60,5,9,175,2025-04-25
IRAO,Открытые позиции,2331,1398,1202,2135,7066,2025-04-25
IRAO,Изменение,83,5,-61,17,44,2025-04-25
IRAO,Количество лиц,264,46,6,6,322,2025-04-25
SNGSP,Открытые позиции,4283,668,81,3696,8728,2025-04-25
SNGSP,Изменение,-57,107,-5,-169,-124,2025-04-25
SNGSP,Количество лиц,378,99,3,14,494,2025-04-25
PLZL,Открытые позиции,666,1461,1327,532,3986,2025-04-25
PLZL,Изменение,24,74,16,-34,80,2025-04-25
PLZL,Количество лиц,165,184,10,8,367,2025-04-25
SPBE,Открытые позиции,39630,37820,19268,21078,117796,2025-04-25
SPBE,Изменение,1799,1266,-145,388,3308,2025-04-25
SPBE,Количество лиц,678,341,17,11,1047,2025-04-25
